# Keywords file for compatibility with Arduino library structure

# Structures:
################################################

midi_message	KEYWORD2
midi_istream	KEYWORD2
midi_ostream	KEYWORD2
midi_sysex_buffer	KEYWORD2

# Functions:
################################################

midi_istream_from_buffer	KEYWORD2
midi_decode	KEYWORD2
midi_decode_usb	KEYWORD2

midi_ostream_from_buffer	KEYWORD2
midi_encode	KEYWORD2
midi_encode_usb	KEYWORD2

# Constants:
################################################

MIDI_STREAM_CAPACITY_UNLIMITED	LITERAL1

MIDI_TYPE_NOTE_OFF	LITERAL1
MIDI_TYPE_NOTE_ON	LITERAL1
MIDI_TYPE_POLYPHONIC_PRESSURE	LITERAL1
MIDI_TYPE_CONTROL_CHANGE	LITERAL1
MIDI_TYPE_PROGRAM_CHANGE	LITERAL1
MIDI_TYPE_CHANNEL_PRESSURE	LITERAL1
MIDI_TYPE_PITCH_BEND	LITERAL1
MIDI_TYPE_TIME_CODE_QUARTER_FRAME	LITERAL1
MIDI_TYPE_SONG_POSITION	LITERAL1
MIDI_TYPE_SONG_SELECT	LITERAL1
MIDI_TYPE_TUNE_REQUEST	LITERAL1
MIDI_TYPE_TIMING_CLOCK	LITERAL1
MIDI_TYPE_START	LITERAL1
MIDI_TYPE_CONTINUE	LITERAL1
MIDI_TYPE_STOP	LITERAL1
MIDI_TYPE_ACTIVE_SENSE	LITERAL1
MIDI_TYPE_SYSTEM_RESET	LITERAL1
MIDI_TYPE_SYSEX	LITERAL1
MIDI_TYPE_SYSTEM_EXCLUSIVE	LITERAL1
